NO ./textures/north.png
SO ./textures/south.png
WE ./textures/west.png
EA ./textures/east.png
F 250, 250 , 250
C 250, 250, 250

1111111111
1000000001
1N00000001
1001110001
1000000001
1001111001
1000000001
1000000001
1111111111