NO ./textures/north.png
SO ./textures/south.png
WE ./textures/west.png
EA ./textures/east.png
F 250, 250 , 250
C 250, 250, 250
111111
1W0001
100001
111111