
F 0, 0, 255
C 52, 235, 158

NO ./textures/north.png
SO ./textures/south.png
WE ./textures/west.png
EA ./textures/east.png

1111111111111111111111111
111110000011100000000000011111
    1001000000000000000000001
    1000000000110000000000001111111111
111111111011000001110000000000001
10000000001100000111011111111111111111
11110111111111011100000010001
11110111111111011101010010001
11000000110101011100000010001
10000000000000000000000010001
10000000000000001101010000001
11000001110101011111011110N0111
11110111 1110101 101111010001
11111111 1111111 111111111111