NO ./textures/north.png
SO ./textures/south.png
WE ./textures/west.png
EA ./textures/east.png
F 250, 0 ,0
C 250, 0, 250

1111111111
1000000001
1E00000001
1111111111