F 50,50,50
C 225,30,0
NO ./textures/test.png
EA ./textures/test3.png
WE ./textures/test1.png
SO ./textures/test2.png


1111111111111111111
1000000000000000001
1111000000000000001
1000000000000000001
1000000000000000001
10000E0000000000001
1000000000000000001
1000000000000001111
1000000101010000001
1111111101111111111
11
1
