NO ./textures/test.png
WE ./textures/test1.png
SO ./textures/test2.png
EA ./textures/test3.png

F 50,50,50
C 225,30,0

1111111111111
11111111111111
