F 50,50,50

NO ./textures/test.png
EA ./textures/test3.png

C 225,30,0


WE ./textures/test1.png
SO ./textures/test2.png

  111111111111111111111
  1000000000000010000001
  00111111100100111000011
  1100000011110000000111
  11000001100111010111
  10000E0000000000001
  1000000000000000001
  1000000000000001111
  1000000101010000001
  1111111111111111111
