NO ./textures/test.png
WE ./textures/test1.png
SO ./textures/test2.png
EA ./textures/test3.png

C  0,           5, 5
F     50,     25,     50

  111111111111111
111001000000001
100001111100111
100011E000001
1111111111111
