11111111111111111111
10000000000000000001
11110000000000000111111
10000000000000000001
 1100000000000000001
  10000E000000000001
  100000000000000001
  1000000000000001111
  1000000101010000001
  1111111111111111111

F 50,50,50
C 225,30,0

NO ./textures/test.png
EA ./textures/test3.png
WE ./textures/test1.png
SO ./textures/test2.png
