NO ./textures/north.png
SO ./textures/south.png
WE ./textures/west.png
EA ./textures/east.png

F 250, 250 , 250
C 250, 250, 250

1111111111111
1001000000001
1000011111001
100011E000001
1111111111111
