NO ./textures/test.png
SO ./textures/test.png
WE ./textures/test1.png
EA ./textures/test1.png
C 255,77,113
F 245,247,189
1111111111111111111111111
1101110101011001001110101
1001010101100101110000001
1101010110100000101100101
1000010111101101010111111
1011101001000101000111101
1001100010001001011011001
1101000000011010010000011
1001010001110110100111011
1101101001011110101000001
1101010111100100110010E11
1100000011000101010111101
1111111111111111111111111
